60
40
############################################################
############################################################
############################################################
###......................................................###
###......................................................###
###..##################################################..###
###..##################################################..###
###..#############..............#######################..###
###..#############..............#######################..###
###..#############..............#######################..###
###..#############..........x...#######################..###
###..#############.....Y........#######################..###
###..#############...............+....................+..###
###.....##########....x.........##......d........Y#####..###
###.....##########..............##.....r.l........#####..###
######..##########..............##.......l........##########
######..############..############.....Y..........##########
###.....############..############................##########
###.....############......########................##......##
###..###############.............+................##......##
###..###################.........#...............x##......##
###..##..x............##############################......##
###..##...............##############################......##
###..##...............#........Y.......#############......##
###..##................................+.........######+####
###..######+###########................#.........######.####
###..##......x.########.............###########..######.####
###..##Y.......##...................###########..######.####
###............##...................####...####..######+####
###............##...................####...#........Y....###
###..##Y.......##..............x....####........x........###
###..##........##...................########################
###..##........#############################################
###..########+##############################################
###.....###..............................................###
#######.################################################.###
#######..................................................###
############################################################
############################################################
############################################################