60
40
############################################################
############################################################
############################################################
#####################........###############################
####################.............###########################
###################..................#######################
################.......................#####################
############.............................###################
##########.................................#################
##########........~~~~......................################
##########........~~~~.....................#################
#########.........~~.......................#################
#########.................................##################
###########..................................###############
##########...................................###############
########....................................################
########....................................################
########......................................##############
################....................####......##############
#################...................####..........##########
####################...............#####..........##########
#####################..........######.................######
#########################....##########..............#######
########...###########################..............########
######.........#######################.............#########
###..........###########################.............#######
###..........#############################..........########
####.........##.....##################............##########
#####...............#####....########....##.....############
######.........###............###...#...####################
#####..........#######........###......#####################
##...........###########...............#####################
##.....###################....###...########################
###...######################################################
############################################################
############################################################
############################################################
############################################################
############################################################
############################################################