60
40
############################################################
############################################################
############################################################
###......................................................###
###......................................................###
###..##################################################..###
###..##################################################..###
###..#############..............#######################..###
###..#############..............#######################..###
###..#############..............#######################..###
###..#############..............#######################..###
###..#############..............#######################..###
###..#############...............+....................+..###
###.....##########..............##..................###..###
###.....##########..............##..................###..###
######..##########..............##..................########
######..############..############..................########
###.....############..############..................########
###.....############......########..................###..###
###..###############.............+..................###..###
###..###################.........#..................###..###
###..##...............#################################..###
###..##...............#################################..###
###..##...............#................################..###
###..##...............+................+.........######..###
###..######+###########................#.........######..###
###..##........########.............###########..######..###
###..##........##...................###########..######..###
###............##...................####...####..######..###
###............##...................####...#.............###
###..##........##...................####.................###
###..##........##...................########################
###..##........#############################################
###..########+##############################################
###.....###..............................................###
#######.################################################.###
#######..................................................###
############################################################
############################################################
############################################################