60
40
############################################################
############################################################
############################################################
###......................................................###
###......................................................###
###..##################################################..###
###..##################################################..###
###..#############..............#######################..###
###..#############..............#######################..###
###..#############..............#######################..###
###..#############..........x...#######################..###
###..#############..............#######################..###
###..#############...............+....................+..###
###.....##########....x.........##..................###..###
###.....##########..............##.....r.l..........###..###
######..##########..............##.......l..........########
######..############..############......u...........########
###.....############..############..................########
###.....############......########..................###..###
###..###############.............+..................###..###
###..###################.........#................x.###..###
###..##..x............#################################..###
###..##...............#################################..###
###..##...............#................################..###
###..##...............+................+.........######..###
###..######+###########................#.........######..###
###..##......x.########.....d.......###########..######..###
###..##........##..........rm.......###########..######..###
###............##...................####...####..######..###
###............##...................####...#.............###
###..##........##..............x....####........x........###
###..##........##...................########################
###..##........#############################################
###..########+##############################################
###.....###..............................................###
#######.################################################.###
#######..................................................###
############################################################
############################################################
############################################################