60
40
############################################################
############################################################
############################################################
#####################........###############################
####################.............###########################
###################..................#######################
################.......................#####################
############.............................###################
##########.................................#################
##########........~~~~......................################
##########........~~~~.....................#################
#########.........~~.......................#################
#########...............................####################
###########..................................###############
##########...................................###############
########....................................################
########....................................################
########......................................##############
###################.................####......##############
#################...................######........##########
####################...............#####..........##########
#####################..........######.................######
#########################....##########..............#######
######################################..............########
######################################.............#########
########################################.............#######
##########################################..........########
#########################################.........##########
###########################################.....############
############################################################
############################################################
############################################################
############################################################
############################################################
############################################################
############################################################
############################################################
############################################################
############################################################
############################################################