60
40
############################################################
############################################################
############################################################
###......................................................###
###......................................................###
###..##################################################..###
###..##################################################..###
###..#############..............#######################..###
###..#############..............#######################..###
###..#############..............#######################..###
###..#############..........x...#######################..###
###..#############.....Y........#######################..###
###..#############...............+....................+..###
###.....##########....x.........##......d...........###..###
###.....##########..............##.....r.l.........Y###..###
######..##########..............##.......l..........########
######..############..############.....Y............########
###.....############..############..................########
###.....############......########..................###..###
###..###############.............+..................###..###
###..###################.........#................x.###..###
###..##..x............#################################..###
###..##...............#################################..###
###..##...............#........Y.......################..###
###..##...............+................+.........######..###
###..######+###########................#.........######..###
###..##......x.########.....d.......###########..######..###
###..##Y.......##..........rM.......###########..######..###
###............##...................####...####..######..###
###............##...................####...#........Y....###
###..##Y.......##..............x....####........x........###
###..##........##...................########################
###..##........#############################################
###..########+##############################################
###.....###..............................................###
#######.################################################.###
#######..................................................###
############################################################
############################################################
############################################################